word1	word2	accuracy	[comment]
terremoto	scossa	1
patrimonio	azione	0
ebreo	Gerusalemme	1
nuvolosità	previsione	1
dizionario	enciclopedia	1
zecca	museo	1
sedia	sgabello	1
spagnolo	umidità	0	[lingua]
lattina	bottiglia	1
mosca	formica	1
mito	satira	1
centro della città	autobus	-1
coda	Boeing 747-200	0	[coda animale]
opera d'arte	artista	1
NATO	alleanza	1
re	sovrano	0	[re: reggene di una monarchia]
ritmo	cadenza	1
Alexander Fleming	penicillina	1
flauto	musica	0	[flauto: strumento musicale]
airone cenerino	lago	0	[lago]
viscosità	spruzzo	1
hardware	case	0	[case: contenitore]
anello	fidanzamento	0	[fidanzamento]
latino	tedesco	1
classe operaia	fabbrica	1
Shakespeare	Dickens	1
banconota	prete	0
strumento	lavoro	0	[lavoro collegato a professione]
cinghiale nano	suidi	1
suffragio	uscita	0	[uscita: punto di uscita di un luogo]
stella	luminosità	1	[stella: astro]
trota	chitarra	1
dollaro	milionario	0	[dollaro americano]
cifra	numero	1
burrasca	coperta	1
Obama	Clinton	1
personaggio secondario	film	0	[film]
Juventus	Bayern Monaco	1
cambiamento climatico	precipitazione	1
IA	batteria	0	[IA: intelligenza artificiale]
capolavoro	Gioconda	1
crimine	aggressione	1
incoronazione	acqua	-1
vocalista	pentagramma	-1
spareggio	pallacanestro	1
forze armate	difesa	1
lago	nuvola	1
monastero	doccia	1
lingua madre	lingua	1
porto	incarto	0	[porto: luogo in cui attraccano le navi]
demonio	angelo	1
crittogramma	simbolo	0	[simbolo: non simbolismo]
campus	università	1
libertà	libertà	1
tifone	ciclone	1
manuale	guida turistica	1
Ebola	virus Ebola	1
principessa	biscotto	1
treno	tram	-1
ecosistema	economia	0	[economia: campo di studi]
regina regnante	regina degli scacchi	-1
oro	zinco	1
cursore	patatine fritte	0	[patatine fritte: cibo]
Rio delle Amazzoni	foresta	1
tennis	statistica	0
Bolzano	teorema	0	[teorema matematico]
altitudine	conversione	1
barca	albero	1
trono	spada	1
cotone	maglione	1
ciliegia	fragola	0	[frutti]
Islam	Corano	-1
Neanderthal	sport	-1
nepotismo	re	0	[re: monarca]
personaggio	persona	0	[persona come entità]
cisterna	vagone	1
Mercurio	Giove	0	[pianeti]
bronchite	acetaminofene	0
sangue	corpo	-1
islamofobia	ISIS	1
uncinetto	uniforme	0	[uniforme]
Hadoop	touchscreen	1
combustibile fossile	fossile	1
mutante	sociobiologia	0	[mutante: essere che può cambiare la propria forma]
sorella	fratello	1
matita	storia	0	[matita]
eczema	dermatite	1
imperatore	governatore	1
corona	chiave	0	[oggetto usato dai re]
algebra	operazione	0	[operazione matematica]
pistone	motore	1
borsa di studio	retta	1	[borsa di studio]
libro	manoscritto	0	[libro]
lantana	bocca di leone	1
buco nero	vuoto	1
Impero Persiano	Ciro	1
editoriale	notizia	0	[notizia]
decorazione	busta	0	[busta]
squalo balena	aragosta	1
mais	granturco	1